{
  "width": 12,
  "height": 6,
  "slipProbability": 0.1,
  "grid": [
    ["S", "O", "O", "O", "O", "O", "O", "O", "O", "O", "O", "S"],
    ["O", "O", "W", "W", "W", "W", "W", "W", "W", "W", "W", "O"],
    ["O", "O", "O", "O", "O", "O", "O", "O", "O", "G", "W", "O"],
    ["O", "O", "W", "W", "W", "W", "W", "W", "W", "W", "W", "O"],
    ["O", "O", "O", "O", "O", "O", "O", "O", "O", "O", "O", "O"],
    ["O", "O", "O", "O", "O", "O", "O", "O", "O", "O", "O", "S"]
  ]
}