{
  "width": 7,
  "height": 7,
  "grid": [
    ["S", "O", "O", "O", "O", "O", "G"],
    ["O", "W", "W", "W", "W", "W", "O"],
    ["O", "O", "O", "O", "O", "O", "O"],
    ["O", "W", "W", "W", "W", "W", "O"],
    ["O", "W", "W", "W", "W", "W", "O"],
    ["O", "W", "W", "W", "W", "W", "O"],
    ["O", "O", "O", "O", "O", "O", "O"]
  ]
}