{
  "width": 10,
  "height": 8,
  "grid": [
    ["S", "O", "W", "O", "O", "O", "W", "O", "O", "O"],
    ["O", "W", "W", "O", "W", "O", "W", "O", "W", "O"],
    ["O", "W", "O", "O", "W", "O", "O", "O", "W", "O"],
    ["O", "O", "O", "O", "W", "W", "O", "W", "W", "O"],
    ["O", "O", "W", "O", "O", "O", "W", "O", "O", "O"],
    ["O", "W", "W", "O", "W", "O", "W", "W", "W", "O"],
    ["O", "W", "W", "O", "W", "O", "O", "O", "W", "O"],
    ["O", "O", "W", "O", "W", "O", "O", "W", "W", "G"]
  ]
}