{
  "width": 12,
  "height": 6,
  "grid": [
    ["S", "O", "W", "W", "O", "O", "O", "W", "O", "O", "O", "O"],
    ["O", "O", "W", "W", "O", "W", "O", "W", "O", "W", "O", "O"],
    ["O", "O", "W", "W", "O", "W", "O", "O", "O", "W", "O", "O"],
    ["O", "O", "O", "O", "O", "W", "W", "W", "W", "W", "O", "O"],
    ["O", "O", "W", "W", "O", "O", "O", "O", "O", "O", "O", "O"],
    ["O", "O", "O", "O", "O", "W", "W", "W", "W", "W", "G", "O"]
  ]
}